XXOXXOXXXX
XOOOOOOOOX
XXOXXXXXXX
XXOOOOOXXX
XXXXXXOOOO
XXXXXXXXXX