XXXXXXXXXX
OOOOOOOOOX
XXOXXXXXXX
XXOOOOOXXX
XXXXXXOOOO
XXXXXXXXXX